Icy Amnesia
An Interactive Fiction by Ram White
Release 1 / Serial number 250910 / Inform 7 v10.1.2 / D

? ? ?
You awaken immediatly beginning to shiver yet your skin burns, a searing pain engulfing your entire body.

>Survey
You can only describe your surroundings as blinding, barely a visible landscape coated in screaming winds. The only thing you can see is foot prints leading north, as you see the tracks your skin sears from the freezing winds reminding you the danger your in

* * *

Icy Amnesia
An Interactive Fiction by Ram White
Release 1 / Serial number 250910 / Inform 7 v10.1.2 / D

? ? ?
You awaken immediatly beginning to shiver yet your skin burns, a searing pain engulfing your entire body.

>description
That's not a verb I recognise.

>examine
What do you want to examine?

>room
You can't see any such thing.

>look
? ? ?
You awaken immediatly beginning to shiver yet your skin burns, a searing pain engulfing your entire body.

* * *

Icy Amnesia
An Interactive Fiction by Ram White
Release 1 / Serial number 250910 / Inform 7 v10.1.2 / D

? ? ?
You awaken immediatly beginning to shiver yet your skin burns, a searing pain engulfing your entire body.

>look
? ? ?
.

>look
? ? ?
You awaken immediatly beginning to shiver yet your skin burns, a searing pain engulfing your entire body.

>examine
What do you want to examine?

* * *

>room
You can't see any such thing.

>examine ???
You can't see any such thing.

>examine room ???
You can't see any such thing.

>describe room
You can't see any such thing.

* * *

Icy Amnesia
An Interactive Fiction by Ram White
Release 1 / Serial number 250910 / Inform 7 v10.1.2 / D

? ? ?
You awaken immediatly beginning to shiver yet your skin burns, a searing pain engulfing your entire body.

>look around
You can't see any such thing.

>look
? ? ?
You awaken immediatly beginning to shiver yet your skin burns, a searing pain engulfing your entire body.

* * *

Icy Amnesia
An Interactive Fiction by Ram White
Release 1 / Serial number 250910 / Inform 7 v10.1.2 / D

? ? ?
You awaken immediatly beginning to shiver yet your skin burns, a searing pain engulfing your entire body.

>n
Abandoned House
The house is barely holding together, barely assisting you from freezing.

You can see Creepy Figure here.

* * *

Icy Amnesia
An Interactive Fiction by Ram White
Release 1 / Serial number 250910 / Inform 7 v10.1.2 / D

? ? ?
You awaken immediatly beginning to shiver yet your skin burns, a searing pain engulfing your entire body.

>survey
You can only describe your surroundings as blinding, barely a visible landscape coated in screaming winds. The only thing you can see is foot prints leading north, as you see the tracks your skin sears from the freezing winds reminding you the danger your in.

>Survey
That's not a verb I recognise.

* * *

>survey
You can only describe your surroundings as blinding, barely a visible landscape coated in screaming winds. The only thing you can see is foot prints leading north, as you see the tracks your skin sears from the freezing winds reminding you the danger your in.

>survey
You can only describe your surroundings as blinding, barely a visible landscape coated in screaming winds. The only thing you can see is foot prints leading north, as you see the tracks your skin sears from the freezing winds reminding you the danger your in.

You froze to death.

    *** The End ***

Would you like to RESTART, RESTORE a saved game, QUIT or UNDO the last command?

>restart
Icy Amnesia
An Interactive Fiction by Ram White
Release 1 / Serial number 250910 / Inform 7 v10.1.2 / D

? ? ?
You awaken immediatly beginning to shiver yet your skin burns, a searing pain engulfing your entire body.

>survey
You can only describe your surroundings as blinding, barely a visible landscape coated in screaming winds. The only thing you can see is foot prints leading north, as you see the tracks your skin sears from the freezing winds reminding you the danger your in.

>north
Abandoned House
The house is barely holding together, assisting you not from freezing, in the corner is a Creepy Figure.

You can see Creepy Figure and Rickity Table (on which is Bloody Icepick) here.

>examine bloody icepick
A tool used for climbing large icy surfaces, the jagged teeth of the tool are tinged in fresh blood. Perhaps it would be good for opening stuff.

>restart
Are you sure you want to restart?

>yes
Icy Amnesia
An Interactive Fiction by Ram White
Release 1 / Serial number 250910 / Inform 7 v10.1.2 / D

? ? ?
You awaken immediatly beginning to shiver yet your skin burns, a searing pain engulfing your entire body.

>survey
You can only describe your surroundings as blinding, barely a visible landscape coated in screaming winds. The only thing you can see is foot prints leading north, as you see the tracks your skin sears from the freezing winds reminding you the danger your in.

* * *

>north
Abandoned House
The house is barely holding together, assisting you not from freezing, in the corner is a Creepy Figure.

You can see Creepy Figure and Rickity Table (on which is Bloody Icepick) here.

>exmaine bloody icepiuck
That's not a verb I recognise.

>restart
Are you sure you want to restart?