Hi, Thank you for checking out my game! To help you through the experiance I have created the unique action "survey" It will help describe your surroundings and replaces the "look" action. You can use the inputs "survey, look, L" to survey. Thank you for trying my game! I hope you rage.

Icy Amnesia
An Interactive Fiction by Ram White
Release 1 / Serial number 251008 / Inform 7 v10.1.2 / D

You awaken immediatly beginning to shiver yet your skin burns, a searing pain engulfing your entire body. You try to remember something but to no avail.

I beg your pardon?

* * *

Hi, Thank you for checking out my game! To help you through the experiance I have created the unique action "survey" It will help describe your surroundings and replaces the "look" action. You can use the inputs "survey, look, L" to survey. Thank you for trying my game! I hope you rage.

Icy Amnesia
An Interactive Fiction by Ram White
Release 1 / Serial number 251008 / Inform 7 v10.1.2 / D

You awaken immediatly beginning to shiver yet your skin burns, a searing pain engulfing your entire body. You try to remember something but to no avail.

>Look
? ? ?
You awaken immediatly beginning to shiver yet your skin burns, a searing pain engulfing your entire body, looking around frantically you see the distant shape of a tree south of you and east you see a small cave.

* * *

Hi, Thank you for checking out my game! To help you through the experiance I have created the unique action "survey" It will help describe your surroundings and replaces the "look" action. You can use the inputs "survey, look, L" to survey. Thank you for trying my game! I hope you rage.

Icy Amnesia
An Interactive Fiction by Ram White
Release 1 / Serial number 251008 / Inform 7 v10.1.2 / D

You awaken immediatly beginning to shiver yet your skin burns, a searing pain engulfing your entire body. You try to remember something but to no avail.

>Survey
You can only describe your surroundings as blinding, barely a visible landscape coated in screaming winds. The only thing you can see is foot prints of something barefoot and huminoid leading north, as you see the tracks your skin sears from the freezing winds reminding you of the danger your in.

>Look
? ? ?
You awaken immediatly beginning to shiver yet your skin burns, a searing pain engulfing your entire body, looking around frantically you see the distant shape of a tree south of you and east you see a small cave.

Your heart was claimed by frostbite.

    *** The End ***

Would you like to RESTART, RESTORE a saved game, QUIT or UNDO the last command?

* * *

>Survey
You can only describe your surroundings as blinding, barely a visible landscape coated in screaming winds. The only thing you can see is foot prints of something barefoot and huminoid leading north, as you see the tracks your skin sears from the freezing winds reminding you of the danger your in.

>survey
You can only describe your surroundings as blinding, barely a visible landscape coated in screaming winds. The only thing you can see is foot prints leading north, as you see the tracks your skin sears from the freezing winds reminding you the danger your in.

You froze to death.

    *** The End ***

Would you like to RESTART, RESTORE a saved game, QUIT or UNDO the last command?

>restart
Icy Amnesia
An Interactive Fiction by Ram White
Release 1 / Serial number 250923 / Inform 7 v10.1.2 / D

? ? ?
You awaken immediatly beginning to shiver yet your skin burns, a searing pain engulfing your entire body.

>survey
You can only describe your surroundings as blinding, barely a visible landscape coated in screaming winds. The only thing you can see is foot prints leading north, as you see the tracks your skin sears from the freezing winds reminding you the danger your in.

>n
Abandoned House
The house is barely holding together, assisting you not from freezing, in the corner is a Creepy Figure.

You can see Creepy Figure and Rickity Table (on which is Bloody Icepick) here.

* * *

Hi, Thank you for checking out my game! To help you through the experiance I have created the unique action "survey" It will help describe your surroundings and replaces the "look" action. You can use the inputs "survey, look, L" to survey. Thank you for trying my game! I hope you rage.

Icy Amnesia
An Interactive Fiction by Ram White
Release 1 / Serial number 251008 / Inform 7 v10.1.2 / D

You awaken immediatly beginning to shiver yet your skin burns, a searing pain engulfing your entire body. You try to remember something but to no avail.

>description
That's not a verb I recognise.

>examine
What do you want to examine?

>room
You can't see any such thing.

>look
? ? ?
You awaken immediatly beginning to shiver yet your skin burns, a searing pain engulfing your entire body.

* * *

Hi, Thank you for checking out my game! To help you through the experiance I have created the unique action "survey" It will help describe your surroundings and replaces the "look" action. You can use the inputs "survey, look, L" to survey. Thank you for trying my game! I hope you rage.

Icy Amnesia
An Interactive Fiction by Ram White
Release 1 / Serial number 251008 / Inform 7 v10.1.2 / D

You awaken immediatly beginning to shiver yet your skin burns, a searing pain engulfing your entire body. You try to remember something but to no avail.

>l
looking around frantically you can only describe your surroundings as blinding, barely a visible landscape coated in screaming winds. Then you see the distant shape of a tree south of you, east of you a small cave, and North a trail of footprints something barefoot and huminoid. As you see the tracks your skin sears from the freezing winds reminding you of the danger your in.

>L
? ? ?
You awaken immediatly beginning to shiver yet your skin burns, a searing pain engulfing your entire body, looking around frantically you see the distant shape of a tree south of you and east you see a small cave.

Your heart was claimed by frostbite.

    *** The End ***

Would you like to RESTART, RESTORE a saved game, QUIT or UNDO the last command?

* * *

>l
looking around frantically you can only describe your surroundings as blinding, barely a visible landscape coated in screaming winds. Then you see the distant shape of a tree south of you, east of you a small cave, and North a trail of footprints something barefoot and huminoid. As you see the tracks your skin sears from the freezing winds reminding you of the danger your in.

>e
You can't go that way.

Your heart was claimed by frostbite.

    *** The End ***

Would you like to RESTART, RESTORE a saved game, QUIT or UNDO the last command?

>restart
Hi, Thank you for checking out my game! To help you through the experiance I have created the unique action "survey" It will help describe your surroundings and replaces the "look" action. You can use the inputs "survey, look, L" to survey. Thank you for trying my game! I hope you rage.

Icy Amnesia
An Interactive Fiction by Ram White
Release 1 / Serial number 251001 / Inform 7 v10.1.2 / D

You awaken immediatly beginning to shiver yet your skin burns, a searing pain engulfing your entire body. You try to remember something but to no availe.

>down
You can't go that way.

>up
You can't go that way.

Your heart was claimed by frostbite.

    *** The End ***

Would you like to RESTART, RESTORE a saved game, QUIT or UNDO the last command?

>restart
Hi, Thank you for checking out my game! To help you through the experiance I have created the unique action "survey" It will help describe your surroundings and replaces the "look" action. You can use the inputs "survey, look, L" to survey. Thank you for trying my game! I hope you rage.

Icy Amnesia
An Interactive Fiction by Ram White
Release 1 / Serial number 251001 / Inform 7 v10.1.2 / D

You awaken immediatly beginning to shiver yet your skin burns, a searing pain engulfing your entire body. You try to remember something but to no availe.

>n
As you follow the huminoid tracks a Abandoned House comes into view, It's amazing how it somehow still stands. But you don't have time to gauk with your skin visibly turning blue, you rush towards the house. Once you step foot inside the eroded huts door slams shut. Panicked you try to peel the door open but try as you might it won't budge.

>l
The house is barely holding together and visibly swaying, The wind whistle is deafening. In the corner of your eye you catch movement, hunched in the corner subtly rocking in tune with the huts sway is a Creepy Figure. Beneath you is a messy rug

>speak to creepy figure
I didn't understand that sentence.

>talk
That's not a verb I recognise.

>speak
I didn't understand that sentence.

>n
You can't go that way.

>l
The house is barely holding together and visibly swaying, The wind whistle is deafening. In the corner of your eye you catch movement, hunched in the corner subtly rocking in tune with the huts sway is a Creepy Figure. Beneath you is a messy rug

>kick door
That's not a verb I recognise.

>look
The house is barely holding together and visibly swaying, The wind whistle is deafening. In the corner of your eye you catch movement, hunched in the corner subtly rocking in tune with the huts sway is a Creepy Figure. Beneath you is a messy rug
The Creepy Figure finally stops weeping, you pause and stare at it. Holding still you attempt to control your breathing unsure of what to do and In the blink of a eye the Creepy Figure lunges at you teeth and claws bared against you.

    *** The End ***

Would you like to RESTART, RESTORE a saved game, QUIT or UNDO the last command?

>restart
Hi, Thank you for checking out my game! To help you through the experiance I have created the unique action "survey" It will help describe your surroundings and replaces the "look" action. You can use the inputs "survey, look, L" to survey. Thank you for trying my game! I hope you rage.

Icy Amnesia
An Interactive Fiction by Ram White
Release 1 / Serial number 251001 / Inform 7 v10.1.2 / D

You awaken immediatly beginning to shiver yet your skin burns, a searing pain engulfing your entire body. You try to remember something but to no availe.

* * *

>n
As you follow the huminoid tracks a Abandoned House comes into view, It's amazing how it somehow still stands. But you don't have time to gauk with your skin visibly turning blue, you rush towards the house. Once you step foot inside the eroded huts door slams shut. Panicked you try to peel the door open but try as you might it won't budge.

>kick door
That's not a verb I recognise.

>open hatch door
I only understood you as far as wanting to open Hidden Hatch.

>go to abandoned hut
You can't see any such thing.

* * *

>l
looking around frantically you can only describe your surroundings as blinding, barely a visible landscape coated in screaming winds. Then you see the distant shape of a tree south of you, east of you a small cave, and North a trail of footprints something barefoot and huminoid. As you see the tracks your skin sears from the freezing winds reminding you of the danger your in.

>n
As you follow the huminoid tracks a Abandoned House comes into view, It's amazing how it somehow still stands. But you don't have time to gauk with your skin visibly turning blue, you rush towards the house. Once you step foot inside the eroded huts door slams shut. Panicked you try to peel the door open but try as you might it won't budge.

>s
(first opening Creaky Door)
It isn't something you can open.

>s
(first opening Creaky Door)
It isn't something you can open.

>s
(first opening Creaky Door)
It isn't something you can open.

The Creepy Figure finally stops weeping, you pause and stare at it. Holding still you attempt to control your breathing unsure of what to do and In the blink of a eye the Creepy Figure lunges at you teeth and claws bared against you.

    *** The End ***

Would you like to RESTART, RESTORE a saved game, QUIT or UNDO the last command?

* * *

Hi, Thank you for checking out my game! To help you through the experiance I have created the unique action "survey" It will help describe your surroundings and replaces the "look" action. You can use the inputs "survey, look, L" to survey. Thank you for trying my game! I hope you rage.

Icy Amnesia
An Interactive Fiction by Ram White
Release 1 / Serial number 251008 / Inform 7 v10.1.2 / D

You awaken immediatly beginning to shiver yet your skin burns, a searing pain engulfing your entire body. You try to remember something but to no avail.

>look
You awaken immediatly beginning to shiver yet your skin burns, a searing pain engulfing your entire body, looking around frantically.You can only describe your surroundings as blinding, barely a visible landscape coated in screaming winds. The you see the distant shape of a tree south of you, east you see a small cave, West you see nothing. North leads a trail of footprints of something barefoot and huminoid, as you see the tracks your skin sears from the freezing winds reminding you of the danger your in.

>look
? ? ?
You awaken immediatly beginning to shiver yet your skin burns, a searing pain engulfing your entire body.

>examine
What do you want to examine?

* * *

>room
You can't see any such thing.

>examine ???
You can't see any such thing.

>examine room ???
You can't see any such thing.

>describe room
You can't see any such thing.

* * *

Hi, Thank you for checking out my game! To help you through the experiance I have created the unique action "survey" It will help describe your surroundings and replaces the "look" action. You can use the inputs "survey, look, L" to survey. Thank you for trying my game! I hope you rage.

Icy Amnesia
An Interactive Fiction by Ram White
Release 1 / Serial number 251008 / Inform 7 v10.1.2 / D

You awaken immediatly beginning to shiver yet your skin burns, a searing pain engulfing your entire body. You try to remember something but to no avail.

>look around
You can't see any such thing.

>look
? ? ?
You awaken immediatly beginning to shiver yet your skin burns, a searing pain engulfing your entire body.

* * *

Hi, Thank you for checking out my game! To help you through the experiance I have created the unique action "survey" It will help describe your surroundings and replaces the "look" action. You can use the inputs "survey, look, L" to survey. Thank you for trying my game! I hope you rage.

Icy Amnesia
An Interactive Fiction by Ram White
Release 1 / Serial number 251008 / Inform 7 v10.1.2 / D

You awaken immediatly beginning to shiver yet your skin burns, a searing pain engulfing your entire body. You try to remember something but to no avail.

>n
As you follow the huminoid tracks a Abandoned House comes into view, It's amazing how it somehow still stands. But you don't have time to gauk with your skin visibly turning blue, you rush towards the house. Once you step foot inside the eroded huts door slams shut. Panicked you try to peel the door open but try as you might it won't budge.

>look
Abandoned House
The house is barely holding together, assisting you not from freezing, in the corner is a Creepy Figure.

You can see Hidden Hatch and a Creepy Figure here.

* * *

>n
As you follow the huminoid tracks a Abandoned House comes into view, It's amazing how it somehow still stands. But you don't have time to gauk with your skin visibly turning blue, you rush towards the house. Once you step foot inside the eroded huts door slams shut. Panicked you try to peel the door open but try as you might it won't budge.

>s
? ? ?
You awaken immediatly beginning to shiver yet your skin burns, a searing pain engulfing your entire body.

* * *

>look
Abandoned House
The house is barely holding together, assisting you not from freezing, in the corner is a Creepy Figure.

You can see Hidden Hatch and a Creepy Figure here.

* * *

Hi, Thank you for checking out my game! To help you through the experiance I have created the unique action "survey" It will help describe your surroundings and replaces the "look" action. You can use the inputs "survey, look, L" to survey. Thank you for trying my game! I hope you rage.

Icy Amnesia
An Interactive Fiction by Ram White
Release 1 / Serial number 251008 / Inform 7 v10.1.2 / D

You awaken immediatly beginning to shiver yet your skin burns, a searing pain engulfing your entire body. You try to remember something but to no avail.

>s
Gruesome Tree
You approach the distant shape of a tree and the closer you get the more you notice the gruesome sight layed out before you. The dead tree is rought with maggots, flies, and roaches which happily gorge on the bloated hanging bodies strung along it's branches. Rotten blood still drips from their bodies and stains the once lovely snow and more beatiful shade of crimson... Wait what are you thinking? This is disgusting! But... You can't help but feel and attraction towards the tree... Yes... It's such a beautiful thing... You so beautiful you stop feeling cold. You should join them on the tree... Become part of the symphony of death...

You die happily as you join them upon the tree, now and forever part of the symphony of death.

    *** The End ***

Would you like to RESTART, RESTORE a saved game, QUIT or UNDO the last command?

* * *

Hi, Thank you for checking out my game! To help you through the experiance I have created the unique action "survey" It will help describe your surroundings and replaces the "look" action. You can use the inputs "survey, look, L" to survey. Thank you for trying my game! I hope you rage.

Icy Amnesia
An Interactive Fiction by Ram White
Release 1 / Serial number 251008 / Inform 7 v10.1.2 / D

You awaken immediatly beginning to shiver yet your skin burns, a searing pain engulfing your entire body. You try to remember something but to no avail.

>survey
You can only describe your surroundings as blinding, barely a visible landscape coated in screaming winds. The only thing you can see is foot prints leading north, as you see the tracks your skin sears from the freezing winds reminding you the danger your in.

>Survey
That's not a verb I recognise.

* * *

>survey
You can only describe your surroundings as blinding, barely a visible landscape coated in screaming winds. The only thing you can see is foot prints leading north, as you see the tracks your skin sears from the freezing winds reminding you the danger your in.

>survey
You can only describe your surroundings as blinding, barely a visible landscape coated in screaming winds. The only thing you can see is foot prints leading north, as you see the tracks your skin sears from the freezing winds reminding you the danger your in.

You froze to death.

    *** The End ***

Would you like to RESTART, RESTORE a saved game, QUIT or UNDO the last command?

>restart
Icy Amnesia
An Interactive Fiction by Ram White
Release 1 / Serial number 250910 / Inform 7 v10.1.2 / D

? ? ?
You awaken immediatly beginning to shiver yet your skin burns, a searing pain engulfing your entire body.

>survey
You can only describe your surroundings as blinding, barely a visible landscape coated in screaming winds. The only thing you can see is foot prints leading north, as you see the tracks your skin sears from the freezing winds reminding you the danger your in.

>north
Abandoned House
The house is barely holding together, assisting you not from freezing, in the corner is a Creepy Figure.

You can see Creepy Figure and Rickity Table (on which is Bloody Icepick) here.

>examine bloody icepick
A tool used for climbing large icy surfaces, the jagged teeth of the tool are tinged in fresh blood. Perhaps it would be good for opening stuff.

>restart
Are you sure you want to restart?

>yes
Icy Amnesia
An Interactive Fiction by Ram White
Release 1 / Serial number 250910 / Inform 7 v10.1.2 / D

? ? ?
You awaken immediatly beginning to shiver yet your skin burns, a searing pain engulfing your entire body.

>survey
You can only describe your surroundings as blinding, barely a visible landscape coated in screaming winds. The only thing you can see is foot prints leading north, as you see the tracks your skin sears from the freezing winds reminding you the danger your in.

* * *

>north
Abandoned House
The house is barely holding together, assisting you not from freezing, in the corner is a Creepy Figure.

You can see Creepy Figure and Rickity Table (on which is Bloody Icepick) here.

>exmaine bloody icepiuck
That's not a verb I recognise.

>restart
Are you sure you want to restart?